15 15 15 15 15 15 15 28 15 15 15 15 15 15 15 15 15 15 15 15 15 15 15 15 15 15 15 15 15 15 15 15 15 15 15 15 15 15 15 15 15 15 15 15 15 15 15 15 15 15 
15 15 15 15 15 15 15 15 15 15 15 15 15 15 15 15 15 15 15 15 15 15 15 15 15 15 15 15 15 15 15 15 15 15 15 15 15 15 15 15 15 15 15 28 15 15 15 15 15 15 
15 15 15 15 15 15 15 15 15 15 15 15 15 15 15 15 15 15 15 15 28 15 15 15 15 15 15 15 15 15 15 15 15 15 15 15 15 15 15 15 15 15 15 15 15 15 15 15 15 15 
15 15 15 28 15 15 15 15 15 15 15 15 15 15 15 15 28 15 15 15 15 15 15 15 15 15 15 15 15 15 15 15 15 15 15 15 15 15 15 15 15 15 15 15 15 15 15 15 15 15 
15 15 15 15 15 15 15 15 15 15 28 15 15 15 15 15 15 15 15 15 15 15 15 15 15 15 15 28 15 15 15 15 15 15 15 15 28 15 15 15 15 15 15 15 15 15 15 15 15 15 
15 15 15 15 15 15 28 15 15 15 15 15 15 16 26 26 26 26 26 26 26 26 26 26 26 26 26 26 26 26 26 26 17 15 15 16 26 26 26 26 26 26 17 15 15 15 15 15 15 15 
15 15 15 28 15 15 15 15 15 15 15 15 15 24 12 12 12 12 12 12 12 12 12 12 12 12 12 12 12 12 12 12 25 15 15 24 12 12 12 12 12 12 25 15 15 15 15 15 15 15
15 15 15 15 15 15 15 15 15 16 26 26 26 20 12 13 13 12 12 12 12 12 12 12 12 12 12 12 12 12 12 12 25 15 15 24 12 12 12 12 12 12 25 15 15 15 15 15 15 28
15 15 15 15 15 15 15 15 15 24 13 13 13 13 13 13 13 12 12 12 12 12 12 12 12 12 12 12 12 12 12 12 25 15 15 24 12 12 12 12 12 12 25 15 15 15 15 15 15 15  
15 15 15 15 15 15 15 16 26 20 13 13 13 13 13 13 13 13 13 13 13 13 12 12 12 12 12 12 12 12 12 12 25 15 15 24 12 12 12 12 12 12 25 15 15 15 15 28 15 15 
15 15 15 15 15 15 15 24 12 13 12 12 12 13 13 13 13 13 13 13 12 12 12 12 12 12 12 12 12 12 12 12 25 15 15 24 12 12 12 12 12 12 25 15 15 15 15 15 15 15 
15 15 15 15 15 15 15 24 12 12 12 12 12 12 12 13 12 12 13 12 12 13 12 12 12 12 12 12 12 12 12 12 25 15 15 24 12 12 12 12 12 12 25 15 15 15 15 15 15 15 
15 15 15 15 15 15 15 24 12 12 12 12 12 12 12 12 12 12 13 12 12 12 12 12 12 12 12 12 12 12 12 12 25 15 15 18 27 21 12 23 27 27 19 15 15 15 15 15 15 15 
15 15 15 15 15 15 15 24 12 12 14 12 12 12 12 13 12 12 12 12 12 12 12 12 12 12 12 12 12 12 12 12 22 26 26 26 26 20 12 25 15 15 15 15 15 15 28 15 15 15
28 15 15 15 28 15 15 24 13 13 13 13 13 13 12 12 12 12 12 12 12 12 12 12 12 12 12 12 12 12 12 12 12 12 12 12 12 12 12 22 26 26 17 15 15 15 15 15 15 15
15 15 15 15 15 15 15 24 13 13 13 14 13 14 13 13 13 13 13 13 12 12 12 12 12 12 12 12 12 12 12 12 12 12 12 12 12 12 12 12 12 12 25 15 15 15 15 15 15 15
15 15 15 15 15 15 15 24 13 14 13 14 13 13 13 13 13 13 13 13 12 12 12 12 12 12 12 12 12 12 12 12 12 12 12 12 12 12 12 12 12 12 25 15 15 15 15 15 15 15 
15 15 15 15 15 15 15 24 13 14 14 12 14 12 13 13 13 12 12 12 12 13 12 12 12 12 12 12 12 12 12 12 12 12 12 12 12 12 12 12 12 12 25 15 15 15 15 28 15 15 
15 15 15 15 15 15 15 24 13 12 12 12 13 13 12 13 12 13 13 13 13 12 13 13 13 13 12 12 12 12 12 12 12 12 12 12 12 12 12 12 12 12 25 15 15 15 15 15 15 15 
15 15 15 15 15 15 15 24 14 12 14 12 12 13 12 14 13 13 13 13 13 12 12 13 12 12 12 12 12 12 12 12 12 12 12 12 12 12 12 12 12 12 25 15 15 15 15 15 15 15 
15 15 15 15 15 15 15 24 13 14 12 11 29 12 12 13 13 12 13 12 12 13 13 12 13 12 12 12 12 12 12 12 12 12 12 12 12 12 12 12 12 12 25 15 15 28 15 15 15 15 
15 15 15 15 15 15 15 24 12 12 14 12 10 12 13 13 13 13 13 13 13 12 12 12 11 12 12 12 12 12 12 12 12 12 12 12 12 12 12 12 12 12 25 15 15 15 15 15 15 15 
15 15 15 15 15 15 15 24 13 13 12 12 10 12 12 13 13 13 13 13 13 12 12 12 12 12 12 12 12 12 12 12 12 12 12 12 12 12 12 12 12 12 25 15 15 15 15 15 15 15 
15 15 15 15 15 15 15 24 14 12 12 11 10 12 12 11 13 13 12 13 13 12 12 12 12 12 12 12 12 12 12 12 12 12 12 12 12 12 12 12 12 12 25 15 15 15 15 15 15 15 
15 15 15 15 15 15 15 24 13 12 11 12 10 10 10 10 10 10 10 10 10 10 10 12 11 12 10 10 10 10 10 10 10 10 10 10 10 12 12 12 12 12 25 15 15 15 15 15 15 15 
15 15 15 15 15 15 15 24 13 12 12 12 12 13 13 13 13 11 13 12 12 12 12 12 12 11 12 12 12 12 12 12 13 12 12 13 10 12 12 12 12 12 25 15 15 15 15 15 15 15 
15 15 15 15 15 15 15 24 14 13 12 12 12 11 13 13 13 12 12 12 12 12 12 12 12 12 12 12 12 12 12 13 12 12 12 12 10 12 12 12 12 12 25 15 15 15 15 28 15 15 
15 15 15 15 28 15 15 24 12 13 12 13 13 13 13 13 13 12 13 12 12 12 12 12 10 12 13 12 12 13 12 12 12 12 13 12 10 12 12 12 12 12 25 15 15 15 15 15 15 15
15 15 15 15 15 15 15 24 13 13 13 13 13 14 13 12 12 13 12 12 13 12 12 12 10 12 12 12 12 12 13 12 12 13 12 12 10 12 12 12 12 12 25 15 15 15 15 15 15 15 
15 15 15 15 15 15 15 24 13 13 13 13 13 13 12 12 13 12 12 12 12 12 12 12 10 12 12 13 13 13 13 13 13 13 13 13 10 12 12 12 12 12 25 15 15 15 15 15 15 15 
15 15 15 15 15 15 15 24 13 13 13 13 13 13 13 13 13 13 12 12 12 12 12 12 10 13 13 13 13 13 13 13 13 13 13 13 10 12 12 12 12 12 25 15 15 15 15 15 15 15 
15 15 15 15 15 15 15 24 13 13 13 13 13 13 13 13 13 13 12 12 12 12 12 12 10 13 13 13 13 13 13 13 13 13 13 13 10 12 12 12 12 12 25 15 15 15 15 15 15 15 
15 15 15 15 15 15 15 24 12 12 12 13 13 13 13 13 12 12 10 10 10 10 10 10 10 10 10 10 10 10 10 10 12 12 12 12 10 10 10 10 10 12 25 15 15 15 15 15 15 15 
15 15 15 15 15 15 15 24 12 12 12 12 12 12 12 12 12 12 10 12 12 12 12 12 12 12 12 12 12 12 12 10 10 10 10 10 10 12 12 13 10 12 25 15 15 15 15 15 15 15 
15 15 15 15 15 15 15 24 12 12 12 12 12 12 12 12 12 12 10 12 12 13 12 12 12 13 13 12 12 13 12 10 12 12 12 12 12 13 12 12 10 14 25 15 15 15 15 28 15 15 
15 15 15 15 15 15 15 24 12 12 12 12 12 12 12 12 12 12 10 12 13 12 12 13 12 12 12 13 12 13 12 10 11 12 12 12 12 12 12 12 10 13 25 15 15 15 15 15 15 15 
15 15 15 15 28 15 15 24 12 12 12 12 12 12 12 12 12 12 10 12 12 12 13 12 12 13 12 12 12 12 12 10 12 12 13 12 14 10 10 10 10 13 25 15 15 15 15 15 15 15 
15 15 15 15 15 15 15 24 12 12 12 23 27 27 27 27 21 12 12 13 13 13 13 13 13 13 13 10 10 10 10 10 10 10 12 12 12 10 13 11 13 12 25 15 15 15 15 15 15 15 
15 15 15 15 15 15 15 24 12 12 12 25 15 15 15 15 24 12 12 13 13 13 13 13 13 13 13 10 13 13 13 13 13 10 12 12 12 10 12 13 13 12 25 15 15 15 15 15 15 15 
15 15 15 15 15 15 15 24 12 12 12 25 15 28 15 15 24 12 13 12 13 13 13 13 13 13 13 10 13 13 13 13 13 10 12 12 13 10 12 13 13 13 25 15 15 28 15 15 15 15 
15 15 15 15 15 15 15 24 12 12 12 25 15 15 15 28 24 12 13 12 13 13 13 13 13 13 13 10 13 13 13 13 13 10 13 12 13 10 13 13 13 13 25 15 15 15 15 15 15 15 
15 15 15 15 15 15 15 24 12 12 12 22 26 26 26 26 20 12 12 13 13 13 13 13 13 13 13 10 13 13 13 13 13 10 10 10 10 10 13 13 13 12 25 15 15 15 15 15 15 15 
15 15 15 15 15 15 15 24 12 12 12 12 12 12 12 12 12 13 12 13 12 13 13 13 13 13 13 13 13 13 13 13 13 13 13 13 13 13 13 13 13 12 25 15 15 15 15 15 15 15
28 15 15 15 28 15 15 24 12 12 12 12 12 12 12 12 12 12 12 12 12 13 13 13 13 13 13 13 13 13 13 13 13 13 13 13 13 13 13 13 13 13 25 15 15 15 15 15 15 15 
15 15 15 15 15 15 15 18 27 27 27 27 27 27 27 27 27 27 27 27 27 27 27 27 27 27 27 27 27 27 27 27 27 27 27 27 27 27 27 27 27 27 19 15 15 15 15 15 15 15 
15 15 15 15 15 15 15 15 15 15 15 15 15 15 15 28 15 15 15 15 15 15 15 15 15 15 15 15 15 15 15 15 15 15 15 15 15 15 15 15 15 15 15 15 15 15 15 15 15 15 
15 15 15 15 15 15 15 28 15 15 15 15 15 15 15 15 15 15 15 15 15 15 15 15 15 15 15 15 15 15 15 15 15 15 15 15 15 15 15 28 15 15 15 15 15 15 15 15 15 15 
15 15 15 15 15 15 15 15 15 15 15 15 15 15 15 15 15 15 15 15 15 15 15 15 15 15 15 15 15 15 15 15 15 15 15 15 15 15 15 15 15 15 15 15 15 15 15 15 15 15 
15 15 15 15 15 15 15 15 15 15 15 15 28 15 15 15 15 15 15 15 15 15 15 15 15 15 28 15 15 15 15 15 15 15 15 15 15 15 15 15 15 15 15 15 15 15 15 15 15 15 
15 15 15 15 15 15 15 15 15 15 15 15 15 15 15 15 15 15 15 15 15 15 15 15 15 15 15 15 15 15 15 15 15 15 15 28 15 15 15 15 15 15 15 15 15 15 28 15 15 15 